#####################################
#####################################
#####################################
### E#     #   #   #    #         ###
### ## ### # # # #   ## ## # #### ###
### ##   #   #   #####     #    # ###
###  ### ##### ####  # ##### #  # ###
### ##   # ###    # ####   ### ## ###
### ## # #   #  # # ## # #        ###
###    #   #   ## # #    ############
### ##### ## ###    # ##     #    ###
### ##    #      #### ### #### # ####
### ## # ######### P    #      #  ###
### #  #  # ##  ## ###### # ##### ###
### ## ####     #         #     # ###
### ##    # ####### ### # ##### # ###
###    #             #        #   ###
#####################################
#####################################
#####################################