#################
#################
#################
###    #  #   ###
### P#    E # ###
###  ######## ###
###           ###
#################
#################
#################