#################
#################
#################
###    #  #   ###
### P#    W # ###
###  ######## ###
###           ###
#################
#################
#################