v2.0 raw
23 23 23 23 23 23 23 23 23 23 23 23 23 23 23
23 23 23 23 23 23 23 23 23 23 23 23 23 23 23
23 23 23 23 23 23 23 23 23 23 23 23 23 23 23
23 23 23 23 23 23 23 23 23 23 23 23 23 23 23
23 23 23 23 23 23 23 23 23 23 23 23 23 23 23
23 23 23 23 23 23 23 23 23 23 23 23 23 23 23
23 23 23 23 23 23 23 23 23 23 23 23 23 23 23
23 23 23 23 23 23 23 23 23 20 45 23 63 20 20
20 20 23 20 20 20 23 20 20 20 23 20 20 20 20
23 20 62 20 20 32 31 31 31 68 23 23 23 23 23
23 20 23 23 20 23 23 23 20 23 20 23 63 23 20
23 20 20 20 23 23 20 23 23 20 23 20 23 23 23
23 23 23 23 23 23 23 23 33 23 23 20 20 20 23
20 31 20 23 20 20 20 23 23 23 23 23 20 20 20
32 20 23 20 20 20 20 23 67 23 23 23 23 23 23
20 64 23 23 23 20 23 23 23 23 23 20 23 23 23
23 20 20 23 20 23 23 23 23 23 20 23 20 20 23
34 23 23 23 23 23 23 34 23 23 20 20 20 23 20
23 23 23 20 20 62 20 23 20 23 23 23 23 20 20
20 23 23 23 20 23 23 32 23 23 23 23 23 23 34
23 23 20 23 20 23 20 20 20 23 20 20 23 31 23
20 23 23 20 23 20 23 20 20 20 20 20 62 20 20
23 23 23 23 23 23 20 20 20 20 23 20 20 20 23
20 20 61 23 23 20 23 20 23 20 20 20 20 23 23
23 23 23 23 23 23 23 23 23 23 23 23 23 20 23
23 23 23 23 20 23 23 31 23 23 23 20 20 20 20
23 32 23 23 20 20 20 20 64 23 20 20 20 20 23
23 23 23 23 23 31 23 23 20 20 20 20 23 20 20
20 20 20 20 23 23 23 23 20 23 23 23 20 23 23
23 23 20 23 20 23 23 23 23 23 23 23 20 23 23
20 23 20 23 23 23 23 23 23 23 23 23 66 20 20
20 20 6a 23 20 20 20 20 20 20 23 20 20 23 23
23 23 23 23 20 23 20 20 23 20 20 23 20 23 23
20 20 23 23 20 23 23 23 23 23 23 20 23 20 23
23 23 23 23 20 23 23 23 23 23 23 20 23 23 20
23 23 23 23 20 31 20 20 20 23 62 20 20 20 20
20 20 20 20 23 20 20 20 20 20 23 31 23 23 23
23 23 23 20 23 23 32 20 20 20 23 20 23 23 23
23 23 23 23 20 23 23 23 20 23 20 23 23 23 23
23 20 23 20 23 23 23 23 23 23 20 20 20 61 23
20 20 20 20 20 20 20 62 20 20 20 20 20 23 20
20 20 31 32 20 69 20 23 20 20 63 23 23 23 23
23 23 23 23 23 23 23 23 23 23 23 23 23 23 23
23 23 23 23 23 23 23 23 23 23 23 23 23 23 23
23 23 23 23 23 23 23 23 23 23 23 23 23 23 23
23 23 23 23 23 23 23 23 23 23 23 23 23 23 23
23 23 23 23 23 23 23 23 23 23 23 23 23 23 23
23 23 23 23 23 23 23 23 23 23 23 23 23 23 23
23 23 23 23 23 23 23 23 23 23 23 23 23 23 23
23 23 23 23 23
