v2.0 raw
23 23 23 23 23 23 23 23 23 23 23 23 23 23 23
23 23 23 23 23 23 23 23 23 23 23 23 23 23 23
23 23 23 23 23 23 23 23 23 23 20 23 20 20 20
23 23 23 23 23 23 23 20 23 20 23 20 23 23 23
23 23 23 20 20 50 20 23 20 23 23 23 23 23 23
20 23 20 20 20 20 23 23 23 23 23 23 20 23 23
20 23 23 23 23 23 23 23 23 20 20 23 20 20 20
23 23 23 23 23 23 23 23 23 23 23 23 23 23 23
23 23 23 23 23 23 23 23 23 23 23 23 23 23 23
23 23 23 23 23 23 23 23 23

