###########
###########
###########
### fjad###
### ##  ###
###  ## ###
###########
###########
###########