############
############
############
#### #   ###
#### # # ###
###  P # ###
### #    ###
### ## #####
###  #   ###
############
############
############