v2.0 raw
0 4 3 2 23 23 23 23 23 23 23 23 23 23 23
23 23 23 23 23 23 23 23 23 23 23 23 23 23 23
23 23 23 23 23 23 23 23 23 23 20 66 6a 61 20
23 23 23 23 23 23 20 23 23 20 32 23 23 23 23
23 23 20 20 23 23 20 23 23 23 23 23 23 23 23
23 23 23 23 23 23 23 23 23 23 23 23 23 23 23
23 23 23 23 23 23 23 23 23 23 23 23 23
