###########
###########
###########
### fja ###
### ## 2###
###  ## ###
###########
###########
###########