#########
#########
##     ##
##  #  ##
##  ## ##
#########
#########