###########
###########
###########
###     ###
###  #  ###
###  ## ###
###########
###########
###########