###########
###########
###########
###     ###
### ##  ###
###  ## ###
###########
###########
###########