########################
########################
########################
###        #     #   ###
### ## 1#     #  # # ###
### #   #######    # ###
### ###    P  ###### ###
###     #  ## #    # ###
### #  #   ##b## #   ###
########################
########################
########################