########################
########################
########################
###        #     #   ###
### ## 1#     #  # # ###
### #   #######    # ###
### ###  11Pag###### ###
###     #  ##1#    # ###
### #  #   ## ## #   ###
########################
########################
########################