########################
########################
########################
###        #     #   ###
### ##  #     #  # # ###
### #   #######    # ###
### ###    P  ###### ###
###     #  #  #    # ###
### #  #   #  ## #   ###
########################
########################
########################