######################
######################
##        #     #   ##
## ##  #     #  # # ##
## #   #######    # ##
## ###       ###### ##
##     #  #  # P  # ##
## #  #   #  ## #   ##
######################
######################