########################
########################
########################
###        #     #   ###
### ## 1#     #  # # ###
### #   #######    # ###
### ###  14Pag###### ###
###     #  ##3#    # ###
### #  #   ##4## #   ###
########################
########################
########################