########
#      #
# ##P  #
# #    #
# ##   #
# # #  #
#   #  #
########
